
111111111111111
120000000000001
101111111111001
100001000000001
111101110111111
100001000000001
101111010101001
100001010000001
101011011101001
100000000000001
101111010101001
101000001001001
101000001001001
101000001101031
111111111111111
