
111111111111111
120000000000001
111111111111001
100001000000001
111101110111111
000001000000001
101111011101001
100001010000001
101011011111001
100000000000001
101111111101001
101100000101001
101000100111001
100001100000031
111111111111111
